NO textures/north.png
SO textures/south.png
WE textures/east.png
EA textures/west.png

F 220,100,0
C 255,30,0

        1111111111111111111111111
        1E00000000110011100000001
        1000000001110000000000001
        1000000000000000000000001
111111111011000001110000000000001
100000000011000001110111111111111
11110111111111011100000010001 
11110111111011011101010010001
11000000111111011100000010001
10000000000000001100010010011                                     
10000000000000001100000010011
11000001110101011111011110001
11110111 1110101 101111010001
11111111 1111111 111111111111