NO textures/north.png
SO textures/south.png
WE textures/east.png
EA textures/west.png

F 220,100,0
C 255,30,0

111111
1S0001
110001
101001
111011
100001
101011
100001
111111
100001
100001
100001
111111
