NO ./path_to_the_north_texture.png
SO ./path_to_the_south_texture.png
WE ./path_to_the_west_texture.png
EA ./path_to_the_east_texture.png

F 220,100,0
C 255,30,0


11111111
10000001
11100101
10000W01
11111111